NO ./texture/3d/north.xpm
SO ./texture/3d/south.xpm
WE ./texture/3d/west.xpm
EA ./texture/3d/east.xpm

F 153,244,0
C 0,84,255

11111111111e1111111111
1000000001000100000001
1000000001R00100000001
1000000001000100000001
1000000001000100000001
10000000011d1100000001
100000HALF000000000001
100000kwbc000000000001
1000000000000000000001
100000000000W000000001
1111111111111111111111