NO ./texture/3d/wall.xpm
SO  ./texture/3d/wall.xpm
WE ./texture/3d/wall.xpm
EA ./texture/3d/wall.xpm

F 95,195,20
C 4,135,226

        1111111111 11111111111111
        1000000000110000000000001
        1011000001110000000000001
        1001000000000000000000001
111111111011000001110000000000001
ewbckLAFRH11000001110111111111111
11110111111111011100000010001
11110111111111011101010010001
11000000110101011100000010001
10000000000000001100000010001
10000000000000011010100000001
11000001110101011111011110N0111
11110111 1110101 101111010001
11111111 1111111 111 11111111