NO ./texture/3d/north.xpm
SO  ./texture/3d/south.xpm
WE ./texture/3d/west.xpm
EA ./texture/3d/east.xpm

F 95,195,20
C 4,135,226

1111111111111111111
1000000000000010001
1110000000000000001
ew0ckLAFRHb001d1011
100000000000N000111
1000000000000000101
1111111111111111111