NO ./texture/3d/wall.xpm
SO  ./texture/3d/wall.xpm
WE ./texture/3d/wall.xpm
EA ./texture/3d/wall.xpm

F 95,195,20
C 4,135,226

        1111111111111111111111111
        1A000000000001100w0000001
        1000k00000000110000000001
1111111111110000000001100000L0001
10000000000d00F000000d00000000001
1000000000110000011111111d1111111
1111d111111111111100000000001
11110111111110001100000000001
110b0000110101011100111111111
10000000000000001100000000001
10cH0000000000011110000000001
1111d11111010101 100110000001
10000001 1110101 10111000N001
10000001 1111111 111 11111111
10R0000e
10000001
11111111