NO ./textures/3d/north.xpm
SO  ./textures/3d/south.xpm
WE ./textures/3d/west.xpm
EA ./textures/3d/east.xpm

F 0,255,0
C 0,0,255


11111111111111111111
10000110000000000001
10000110000000000001
10000110000000000001
10000110000000000001
10000000000000000001
100000N0000000000001
10000000000000000001
10000000000000000001
10000000000000000001
11111111111111111111
